##########
#b X    X#
#        #
#  P     #
#     C  #
#      # #
#  C   #C#
#     O# #
# X    #E#
##########