OOOOOOOOOO
OOOOOOOOOO
##########
#    X X #
#      # #
#E   C C #
######   #
OOOOO#####
OOOOOOOOOO
OOOOOOOOOO
